{
  "tiles" : [ [1, 1, 1, 0, 1, 0, 1, 1, 1 ],
              [1, 1, 0, 1, 1, 1, 0, 1, 1 ],
              [1, 0, 1, 1, 1, 1, 1, 0, 1 ],
              [0, 1, 1, 1, 1, 1, 1, 1, 0 ],
              [1, 1, 1, 1, 0, 1, 1, 1, 1 ],
              [0, 1, 1, 1, 1, 1, 1, 1, 0 ],
              [1, 0, 1, 1, 1, 1, 1, 0, 1 ],
              [1, 1, 0, 1, 1, 1, 0, 1, 1 ],
              [1, 1, 1, 0, 1, 0, 1, 1, 1 ] ],

  "targetScore" : 2000,
  "moves" : 10,
}
