{
  "tiles" : [ [0, 1, 1, 1, 1, 1, 1, 1, 1 ],
              [1, 0, 1, 1, 1, 1, 1, 1, 1 ],
              [1, 1, 0, 1, 1, 1, 1, 1, 1 ],
              [1, 1, 1, 0, 1, 1, 1, 1, 1 ],
              [1, 1, 1, 1, 0, 1, 1, 1, 1 ],
              [1, 1, 1, 1, 1, 0, 1, 1, 1 ],
              [1, 1, 1, 1, 1, 1, 0, 1, 1 ],
              [1, 1, 1, 1, 1, 1, 1, 0, 1 ],
              [1, 1, 1, 1, 1, 1, 1, 1, 0 ] ],

  "targetScore" : 1900,
  "moves" : 8,
}
