{
  "tiles" : [ [0, 1, 1, 1, 1, 1, 1, 1, 0 ],
              [0, 1, 1, 1, 1, 1, 1, 1, 0 ],
              [1, 1, 1, 1, 1, 1, 1, 1, 1 ],
              [1, 1, 1, 1, 0, 1, 1, 1, 1 ],
              [1, 1, 1, 0, 0, 0, 1, 1, 1 ],
              [1, 1, 1, 1, 0, 1, 1, 1, 1 ],
              [1, 1, 1, 1, 1, 1, 1, 1, 1 ],
              [0, 1, 1, 1, 1, 1, 1, 1, 0 ],
              [0, 1, 1, 1, 1, 1, 1, 1, 0 ] ],

  "targetScore" : 4700,
  "moves" : 35,
}
