{
  "tiles" : [ [0, 1, 1, 1, 1, 1, 1, 1, 0 ],
              [0, 1, 1, 1, 1, 1, 1, 1, 0 ],
              [1, 0, 0, 1, 1, 1, 0, 0, 1 ],
              [1, 1, 1, 1, 1, 1, 1, 1, 1 ],
              [1, 1, 1, 1, 1, 1, 1, 1, 1 ],
              [1, 1, 1, 1, 1, 1, 1, 1, 1 ],
              [1, 0, 0, 1, 1, 1, 0, 0, 1 ],
              [0, 1, 1, 1, 1, 1, 1, 1, 0 ],
              [0, 1, 1, 1, 1, 1, 1, 1, 0 ] ],

  "targetScore" : 5000,
  "moves" : 50,
}
